7x10
5x3
WWWWWWWWWWWWWWWWWWWW
WooooCooOWoooooooooW
WoWWoWWWoWoWWWWWWWoW
WooooooooooooooooWoW
WoWWoWWoWWWWWWoWoWoW
WooooWWoWWWWWWoWoWoW
WWWWoWWCWWWWWWoWoWoW
WWWWoWWoWWWWWWoWoWoW
TooooooooboooooooooT
WoWoWWoWWGWWoWoWoWoW
WoWoWWoWpicWoWoWoWoW
WoWOWWoW   WoWoWoWoW
WoWoWWoWWWWWoWoWoWoW
WooooooooooooooooWoW
WoWWoWWWWWWWWWWWoooW
WoWWoWWWWWWWWWWWWooW
WoWoooooooPooooooooW
WoWoWWoWWWWWWoWWoWoW
WooooooooooooooOoooW
WWWWWWWWWWWWWWWWWWWW
