7x10
5x3
WWWWWWWWWWWWWWWWWWWW
WooooCooOWoooooooooW
WoWWoWoWoWoWWWoWWWoW
WooooooooooooooooooW
WoWWoWWoWWWWWWoWoWoW
WooooWWoWWWWWWoWoWoW
WWWWoWWCWWWWWWoWoWoW
WWWWoWWoWWWWWWoWoWoW
TooooooooboooooooooT
WoWoWWoWWGWWoWoWoWoW
WoWoWWoWpicWoWoWoooW
WooOWWoW   WoWoWoWoW
WoWoWWoWWWWWoWoWoooW
WooooooooooooooooWoW
WoWWoWWWWWWWWWWWoWoW
WoWWoWWWWWWWWWWWoWoW
WoWoooooooPooooooooW
WoWoWWoWWWWWWoWWoWoW
WooooooooooooooOoooW
WWWWWWWWWWWWWWWWWWWW
