WWWWWWWWWWWWWWWWWWWW
WooooCooOWoooooooooW
WoWWoWWWoWoWWWWWWWoW
WooooooooooooooooWoW
WoWWoWWoWWWWWWiWoWoW
WooooWWoWWWWWWoWoWoW
WWWWcWWCWWWWWWoWpWoW
WWWWoWWoWWWWWWoWoWoW
oooooooooooooooooooo
WoWoWWoWW WWoWoWoWoW
WoWoWWoW   WoWoWoWoW
WoWOWWoW   WoWoWoWoW
WoWoWWoWWWWWoWoWoWoW
WooooooooooooooboWoW
WoWWoWWWWWWWWWWWoooW
WoWWoWWWWWWWWWWWWooW
WoWoooooooPooooooooW
WoWoWWoWWWWWWoWWoWoW
WooooooooooooooOoooW
WWWWWWWWWWWWWWWWWWWW
