WWWWWWWWWWWWWWWWWWWW
WooooCoooWoooooooooW
WoWWoWWWoWoWWWWWWoW
WooooooooooooooooWoW
WoWWoWWoWWWWWWiWoWoW
WooooWWoWWWWWWoWoWoW
WWWWcWWCWWWWWWoWpWoW
WWWWoWWoWWWWWWoWoWoW
oooooooooooooooooooo
WoWoWWoWWWWWoWoWoWoW
WoWoWWoW   WoWoWoWoW
WoWoWWoW   WoWoWoWoW
WoWoWWoWWWWWoWoWoWoW
WooooooooooooooboWoW
WoWWoWWWWWWWWWWWoooW
WoWWoWWWWWWWWWWWWooW
WoWoooooooPooooooooW
WoWoWWoWWWWWWoWWoWoW
WooooooooooooooooooW
WWWWWWWWWWWWWWWWWWWW
