7x10
5x3
WWWWWWWWWWWWWWWWWWWW
WooooCooOWoooooooooW
WoWWoWoWoWoWoWoWoWoW
WooooooooooooooooooW
WoWWoWWoWWoWoWoWoWoW
WooooWWoWWoWoWoWoooW
WWWWoWWCWWoWoWoooWoW
WWWWoWWoWWoWoWoWoWoW
TooooooooboooooooooT
WoWoWWoWWGWWoWoWoWoW
WoWoWWoWpicWoWoWoooW
WooOWWoW   WoWoWoWoW
WoWoWWoWWWWWoWoWoooW
WooooooooooooooooWoW
WoWWoWWoWWWWoWWWoWoW
WoWWoWWoWWWWoWWWoWoW
WoooooooooPooooooooW
WoWoWWoWWoWWWoWWoWoW
WooooooooooooooOoooW
WWWWWWWWWWWWWWWWWWWW
