WWWWWWWWWWWWWWWWWWWW
WooooCoooWoooooooooW
WoWWoWWWoWoWWWoWWWoW
WooooooooooooooooWoW
WoWWoWWoWWWWWWoWoWoW
WooooWWoWWWWWWoWoWoW
WWWWoWWCWWWWWWoWoWoW
WWWWoWWoWWWWWWoWoWoW
oooooooooooooooooooo
WoWoWWoWWWWWoWoWoWoW
WoWoWWoW   WoWoWoWoW
WoWoWWoW   WoWoWoWoW
WoWoWWoWWWWWoWoWoWoW
WooooooooooooooooWoW
WoWWoWWWWWWWWWWWoooW
WoWWoWWWWWWWWWWWWooW
WoWoooooooPooooooooW
WoWoWWoWWWWWWoWWoWoW
WooooooooooooooooooW
WWWWWWWWWWWWWWWWWWWW
