7x10
5x3
WWWWWWWWWWWWWWWWWWWW
WooooCooOWoooooooooW
WoWWoWWWoWoWWWWWWWoW
WooooooooooooooooWoW
WoWWoWWiWWWWWWoWoWoW
WooooWWoWWWWWWcWoWoW
WWWWoWWCWWWWWWoWoWoW
WWWWoWWoWWWWWWoWoWoW
TooooooooooooooooooT
WoWoWWoWWGWWoWoWoWoW
WoWoWWoW   WoWoWoWoW
WoWOWWoW   WoWoWoWoW
WoWoWWoWWWWWoWoWoWoW
WooooooooooooooboWoW
WoWWoWWWWWWWWWWWoooW
WoWWoWWWWWWWWWWWWooW
WoWoooooooPooooooooW
WoWoWWoWWWWWWoWWoWoW
WopooooooooooooOoooW
WWWWWWWWWWWWWWWWWWWW
